A..................B
#######.............
#..#..#..#..#..#..#.
...####...####..#.#.
#.......###.......##
#..#..#.###..#..#.##
...#..#...#..#......
....##....#######.##
..#....#............
##########..........
....................
....................
....................
....................
.......###..........
.....@.#*#..........
