A..................B
....................
....................
....................
....................
....................
....................
....................
....................
....................
....................
....................
....................
....#########.......
.....@##*#..........