A..................B
#######.............
#..#..#..#..#..#..#.
...####...####..###.
#.......###.......##
#..#..#.###..#..#.##
...#..#...#..#......
....##....##########
..#....#............
##########..........
....................
....................
....................
....................
....................
....................
....................
....................
.......###..........
.....@.#*#..........
