A..................B
#######.............
#..#..#..#..#..#..#.
##.##.##.##.##.##.##
#.......###.......##
#######.....########
...#...#...#...#...#
....##.......##.....
....##.......##.....
..#....#...#....#...
.........#..........
#.#..#.#..#.#..#.#..
...##..##.##..##....
...##..##.##..##....
.......###..........
.....@.#*#..........