A..................B
.##..............##.
.##..............##.
.##..............##.
.##..............##.
.##..............##.
....................
..#..............#..
..##............##..
...##..........##...
.....###########....
....................
##.####.###.##.#..#.
#..#..#.#.#.#..#.##.
#..#..#.###.#..##.#.
##.#..#.#.#.##.#..#.
....................
....................
....#########.......
.....@##*#..........