A..................B
#######.............
#..#..#..#..#..#..#.
##.##.##.##.##.##.##
#.......###.......##
#######.....########
...#...#...#...#...#
....##.......##.....
..#....#...#....#...
.........#..........
....................
#.#..#.#..#.#..#.#..
....................
....................
...##..##.##..##....
...##..##.##..##....
....................
....................
.......###..........
.....@.#*#..........