A..................B
#.################.#
#....#########.....#
##.#########.#.#####
#...##########.#####
#.................##
#################.##
#######...........##
#...........########
#.##############.##.
...##..##.##..##....
...##..##.##..##....
.#.#############....
.#..#########..#....
.#.....###..........
.#..#@.#*#..#..#....