A..................B
#.################.#
#....#########.....#
####.#########.#####
####.........#.#####
############.#.#####
#............#######
#...################
#.................##
#################.##
#######...........##
....................
....................
#.#################.
...##..##.##..##....
...##..##.##..##....
.#.#############....
.#..#########..#....
.#.....###..........
.#..#@.#*#..#..#....